R 800 600

NO ./texture/north.xpm

SO ./texture/south.xpm

WE ./texture/west.xpm

EA ./texture/east.xpm

S ./texture/sprite.xpm

F 0,80,0

C 19,19,70

        1111111111111111111111111
        100000000011001E000000001
        1011000001110001002000001
        1001000000200000000200001
111111111011020001110000002000001
100022000011002001110111111111111
11110111111111011100000010001
11110111111111011101010010001
11200020110101011100000010201
10000000200100001100000010201
10000200020002001101010010201
1122000111010101111101111010111
11110111 1110101 101111010001
11111111 1111111 111111111111