R 800 600

NO ./texture/north.xpm

SO ./texture/south.xpm

WE ./texture/west.xpm

EA ./texture/east.xpm

S ./texture/sprite.xpm

F 0,80,0

C 19,19,70

        1111111111111111111111111
        100000000011001E000000001
        1011000001110001000200001
        1001000000000000000000001
111111111011000001110000000000001
100000000011000001110111111111111
11110111111111011100000010001
11110111111111011101010010001
11000000110101011100000010001
10000000000100001100000010001
10000000000000001101010010001
1100000111010101111101111010111
11110111 1110101 101111010001
11111111 1111111 111111111111