R 800 600

NO ./texture/north.xpm
SO ./texture/south.xpm
WE ./texture/west.xpm
EA ./texture/wood.xpm
S ./texture/greenlight.xpm

F 0,80,0
C 0,0,80

111111111111111111111111111111
100000000000000000011100000001
10E011100000022000011100020001
100211100002000220011100000001
111111111111111100000000200001
111111111111111100011100000001
111111111111111100011100020001
100000000000000000011100000001
101111111111111111111110111101
101111111111111111111110111101
101111111111111111111110111101
101111111111111111111110111101
101111111111111111111110111101
100000000000000000000000111101
100000200000000200000200111101
100000000000000000000000111101
111111111111111111000111111101
111111111111111111000000000001
111111111111111111111111111111
